id,row0,col0,height0,row1,col1,height1
QB5VZDK9,3,6,0,6,3,0
1QCIX083,1,2,0,3,1,2
3257P3SD,1,3,0,3,6,2
762T36LA,1,3,0,3,4,2
1QCIX083,3,1,2,6,4,0
6WGI0XHT,1,2,0,3,1,0
XKPXAB4S,1,4,0,3,5,0
FRUA4GXK,1,3,0,3,1,1
9NFANWJY,3,2,0,6,4,0
FRUA4GXK,3,1,1,6,4,0
Y96MAU4L,1,3,0,3,5,1
3257P3SD,3,6,2,6,5,0
XKPXAB4S,3,5,0,6,5,0
6WGI0XHT,3,1,0,6,2,0
762T36LA,3,4,2,6,2,0
